Bad Day - Daniel Powter
Temperature - Sean Paul
Promiscuous - Nelly Furtado Featuring Timbaland
You're Beautiful - James Blunt
Hips Don't Lie - Shakira Featuring Wyclef Jean
Unwritten - Natasha Bedingfield
Crazy - Gnarls Barkley
Ridin' - Chamillionaire Featuring Krayzie Bone
SexyBack - Justin Timberlake
Check On It - Beyonce Featuring Slim Thug
Be Without You - Mary J. Blige
Grillz - Nelly Featuring Paul Wall, Ali & Gipp
Over My Head (Cable Car) - The Fray
Me & U - Cassie
Buttons - The Pussycat Dolls Featuring Snoop Dogg
Run It! - Chris Brown
So Sick - Ne-Yo
It's Goin' Down - Yung Joc
SOS - Rihanna
I Write Sins Not Tragedies - Panic! At The Disco
Move Along - The All-American Rejects
London Bridge - Fergie
Dani California - Red Hot Chili Peppers
Snap Yo Fingers - Lil Jon Featuring E-40 & Sean Paul Of The YoungBloodZ
Lean Wit It, Rock Wit It - Dem Franchize Boyz Featuring Lil Peanut & Charlay
What Hurts The Most - Rascal Flatts
How To Save A Life - The Fray
Unfaithful - Rihanna
Chasing Cars - Snow Patrol
Lips Of An Angel - Hinder
Everytime We Touch - Cascada
Ain't No Other Man - Christina Aguilera
Dance, Dance - Fall Out Boy
Gold Digger - Kanye West Featuring Jamie Foxx
Money Maker - Ludacris Featuring Pharrell
Ms. New Booty - Bubba Sparxxx Featuring Ying Yang Twins & Mr. ColliPark
(When You Gonna) Give It Up To Me - Sean Paul Featuring Keyshia Cole
Photograph - Nickelback
Because Of You - Kelly Clarkson
Stickwitu - The Pussycat Dolls
I'm N Luv (Wit A Stripper) - T-Pain Featuring Mike Jones
My Humps - The Black Eyed Peas
Where'd You Go - Fort Minor Featuring Holly Brook
Yo (Excuse Me Miss) - Chris Brown
Walk Away - Kelly Clarkson
Laffy Taffy - D4L
What You Know - T.I.
Dirty Little Secret - The All-American Rejects
Savin' Me - Nickelback
Don't Forget About Us - Mariah Carey
Sexy Love - Ne-Yo
U And Dat - E-40 Featuring T-Pain & Kandi Girl
Far Away - Nickelback
What's Left Of Me - Nick Lachey
So What - Field Mob Featuring Ciara
Do It To It - Cherish Featuring Sean Paul Of The YoungBloodZ
Black Horse & The Cherry Tree - KT Tunstall
There It Go! (The Whistle Song) - Juelz Santana
Shoulder Lean - Young Dro Featuring T.I.
Unpredictable - Jamie Foxx Featuring Ludacris
My Love - Justin Timberlake Featuring T.I.
Shake That - Eminem Featuring Nate Dogg
Pullin' Me Back - Chingy Featuring Tyrese
Bossy - Kelis Featuring Too $hort
Chain Hang Low - Jibbs
Smack That - Akon Featuring Eminem
One Wish - Ray J
Sugar, We're Goin' Down - Fall Out Boy
Gimme That - Chris Brown Featuring Lil Wayne
I Know You See It - Yung Joc Featuring Brandy 'Ms. B.' Hambrick
Who Says You Can't Go Home - Bon Jovi
Too Little Too Late - JoJo
Touch It - Busta Rhymes
Rompe - Daddy Yankee
Deja Vu - Beyonce Featuring Jay Z
Life Is A Highway - Rascal Flatts
Call Me When You're Sober - Evanescence
Jesus, Take The Wheel - Carrie Underwood
Show Stopper - Danity Kane
Get Up - Ciara Featuring Chamillionaire
We Be Burnin' - Sean Paul
Hate Me - Blue October
You And Me - Lifehouse
Beep - The Pussycat Dolls Featuring will.i.am
I Think They Like Me - Dem Franchize Boyz Featuring Jermaine Dupri, Da Brat & Bow Wow
Say Goodbye - Chris Brown
Waiting On The World To Change - John Mayer
Soul Survivor - Young Jeezy Featuring Akon
Pump It - The Black Eyed Peas
When I'm Gone - Eminem
Hung Up - Madonna
Stay Fly - Three 6 Mafia Featuring Young Buck & Eightball & MJG
Love - Keyshia Cole
When You're Mad - Ne-Yo
Why You Wanna - T.I.
Stupid Girls - P!nk
Feel Good Inc - Gorillaz
I'm Sprung - T-Pain
Do I Make You Proud - Taylor Hicks
For You I Will (Confidence) - Teddy Geiger
