Irreplaceable - Beyonce
Umbrella - Rihanna Featuring Jay-Z
The Sweet Escape - Gwen Stefani Featuring Akon
Big Girls Don't Cry - Fergie
Buy U A Drank (Shawty Snappin') - T-Pain Featuring Yung Joc
Before He Cheats - Carrie Underwood
Hey There Delilah - Plain White T's
I Wanna Love You - Akon Featuring Snoop Dogg
Say It Right - Nelly Furtado
Glamorous - Fergie Featuring Ludacris
Don't Matter - Akon
Girlfriend - Avril Lavigne
Makes Me Wonder - Maroon 5
Party Like A Rockstar - Shop Boyz
Smack That - Akon Featuring Eminem
This Is Why I'm Hot - Mims
It's Not Over - Daughtry
The Way I Are - Timbaland Featuring Keri Hilson
Fergalicious - Fergie
Crank That (Soulja Boy) - Soulja Boy Tell'em
Give It To Me - Timbaland Featuring Nelly Furtado & Justin Timberlake
What Goes Around...Comes Around - Justin Timberlake
Cupid's Chokehold/Breakfast In America - Gym Class Heroes Featuring Patrick Stump
How To Save A Life - The Fray
Home - Daughtry
My Love - Justin Timberlake Featuring T.I.
Stronger - Kanye West
We Fly High - Jim Jones
U + Ur Hand - P!nk
Walk It Out - Unk
Beautiful Girls - Sean Kingston
This Ain't A Scene, It's An Arms Race - Fall Out Boy
Bartender - T-Pain Featuring Akon
Pop, Lock & Drop It - Huey
Runaway Love - Ludacris Featuring Mary J. Blige
Rockstar - Nickelback
Thnks Fr Th Mmrs - Fall Out Boy
What I've Done - Linkin Park
Summer Love - Justin Timberlake
You - Lloyd Featuring Lil Wayne
Wait For You - Elliott Yamin
Last Night - Diddy Featuring Keyshia Cole
Make It Rain - Fat Joe Featuring Lil Wayne
Make Me Better - Fabolous Featuring Ne-Yo
Ice Box - Omarion
Lips Of An Angel - Hinder
Waiting On The World To Change - John Mayer
Lost Without U - Robin Thicke
I'm A Flirt - R. Kelly Or Bow Wow (Featuring T.I. & T-Pain)
If Everyone Cared - Nickelback
Get It Shawty - Lloyd
Face Down - The Red Jumpsuit Apparatus
The Way I Live - Baby Boy Da Prince Featuring Lil Boosie
Shortie Like Mine - Bow Wow Featuring Chris Brown & Johnta Austin
It Ends Tonight - The All-American Rejects
A Bay Bay - Hurricane Chris
Because Of You - Ne-Yo
I Tried - Bone Thugs-N-Harmony Featuring Akon
Welcome To The Black Parade - My Chemical Romance
Shawty - Plies Featuring T-Pain
Chasing Cars - Snow Patrol
Beautiful Liar - Beyonce & Shakira
SexyBack - Justin Timberlake
Keep Holding On - Avril Lavigne
Let It Go - Keyshia Cole Featuring Missy Elliott & Lil Kim
Apologize - Timbaland Featuring OneRepublic
Bubbly - Colbie Caillat
Like A Boy - Ciara
Who Knew - P!nk
Never Again - Kelly Clarkson
Promise - Ciara
Bed - J. Holiday
Throw Some D's - Rich Boy Featuring Polow Da Don
Rehab - Amy Winehouse
Big Things Poppin' (Do It) - T.I.
No One - Alicia Keys
The Great Escape - Boys Like Girls
2 Step - Unk
Walk Away (Remember Me) - Paula DeAnda Featuring The DEY
Go Getta - Young Jeezy Featuring R. Kelly
Here (In Your Arms) - Hellogoodbye
On The Hotline - Pretty Ricky
Wind It Up - Gwen Stefani
Cyclone - Baby Bash Featuring T-Pain
Break It Off - Rihanna & Sean Paul
First Time - Lifehouse
Ayo Technology - 50 Cent Featuring Justin Timberlake & Timbaland
Outta My System - Bow Wow Featuring T-Pain & Johnta Austin
Teardrops On My Guitar - Taylor Swift
Shut Up And Drive - Rihanna
Snow ((Hey Oh)) - Red Hot Chili Peppers
Money Maker - Ludacris Featuring Pharrell
Kiss Kiss - Chris Brown Featuring T-Pain
Far Away - Nickelback
Rock Yo Hips - Crime Mob Featuring Lil Scrappy
LoveStoned - Justin Timberlake
Better Than Me - Hinder
Paralyzer - Finger Eleven
That's That - Snoop Dogg Featuring R. Kelly
Same Girl - R. Kelly Duet With Usher
