Low - Flo Rida Featuring T-Pain
Bleeding Love - Leona Lewis
No One - Alicia Keys
Lollipop - Lil Wayne Featuring Static Major
Apologize - Timbaland Featuring OneRepublic
No Air - Jordin Sparks Duet With Chris Brown
Love Song - Sara Bareilles
Love In This Club - Usher Featuring Young Jeezy
With You - Chris Brown
Forever - Chris Brown
Sexy Can I - Ray J & Yung Berg
Take A Bow - Rihanna
Viva La Vida - Coldplay
I Kissed A Girl - Katy Perry
Whatever You Like - T.I.
Disturbia - Rihanna
Don't Stop The Music - Rihanna
Pocketful Of Sunshine - Natasha Bedingfield
Kiss Kiss - Chris Brown Featuring T-Pain
Closer - Ne-Yo
Bubbly - Colbie Caillat
Touch My Body - Mariah Carey
4 Minutes - Madonna Featuring Justin Timberlake & Timbaland
So What - P!nk
Paralyzer - Finger Eleven
Clumsy - Fergie
I'm Yours - Jason Mraz
Leavin' - Jesse McCartney
Dangerous - Kardinal Offishall Featuring Akon
Tattoo - Jordin Sparks
See You Again - Miley Cyrus
Shake It - Metro Station
Stop And Stare - OneRepublic
Take You There - Sean Kingston
Paper Planes - M.I.A.
Hot N Cold - Katy Perry
Live Your Life - T.I. Featuring Rihanna
Bust It Baby Part 2 - Plies Featuring Ne-Yo
American Boy - Estelle Featuring Kanye West
Got Money - Lil Wayne Featuring T-Pain
Our Song - Taylor Swift
Damaged - Danity Kane
A Milli - Lil Wayne
Sorry - Buckcherry
Independent - Webbie Featuring Lil' Phat & Lil' Boosie
Can't Believe It - T-Pain Featuring Lil Wayne
Like You'll Never See Me Again - Alicia Keys
Teardrops On My Guitar - Taylor Swift
When I Grow Up - The Pussycat Dolls
Sensual Seduction - Snoop Dogg
What You Got - Colby O'Donis Featuring Akon
It's Not My Time - 3 Doors Down
Better In Time - Leona Lewis
Crank That (Soulja Boy) - Soulja Boy Tell'em
Shadow Of The Day - Linkin Park
Sweetest Girl (Dollar Bill) - Wyclef Jean Featuring Akon, Lil Wayne & Niia
Miss Independent - Ne-Yo
Fall For You - Secondhand Serenade
In The Ayer - Flo Rida Featuring will.i.am
Say - John Mayer
One Step At A Time - Jordin Sparks
Hate That I Love You - Rihanna Featuring Ne-Yo
Superstar - Lupe Fiasco Featuring Matthew Santos
Suffocate - J. Holiday
Let It Rock - Kevin Rudolf Featuring Lil Wayne
Get Like Me - David Banner Featuring Chris Brown
Realize - Colbie Caillat
Put On - Young Jeezy Featuring Kanye West
The Time Of My Life - David Cook
Lolli Lolli (Pop That Body) - Three 6 Mafia Featuring Project Pat, Young D & Superpower
Cyclone - Baby Bash Featuring T-Pain
Love Like This - Natasha Bedingfield Featuring Sean Kingston
Burnin' Up - Jonas Brothers
Love Lockdown - Kanye West
I Luv Your Girl - The-Dream
Crush - David Archuleta
Hypnotized - Plies Featuring Akon
Big Girls Don't Cry - Fergie
Good Life - Kanye West Featuring T-Pain
Womanizer - Britney Spears
Love Story - Taylor Swift
Just Fine - Mary J. Blige
Piece Of Me - Britney Spears
The Boss - Rick Ross Featuring T-Pain
All Summer Long - Kid Rock
Can't Help But Wait - Trey Songz
In Love With A Girl - Gavin DeGraw
My Life - The Game Featuring Lil Wayne
I Remember - Keyshia Cole
Flashing Lights - Kanye West Featuring Dwele
Mrs. Officer - Lil Wayne Featuring Bobby Valentino & Kidd Kidd
7 Things - Miley Cyrus
You're Gonna Miss This - Trace Adkins
Love Remains The Same - Gavin Rossdale
Feels Like Tonight - Daughtry
The Way I Are - Timbaland Featuring Keri Hilson
Addicted - Saving Abel
Into The Night - Santana Featuring Chad Kroeger
Heaven Sent - Keyshia Cole
She Got It - 2 Pistols Featuring T-Pain & Tay Dizm
