Rolling In The Deep - Adele
Party Rock Anthem - LMFAO Featuring Lauren Bennett & GoonRock
Firework - Katy Perry
E.T. - Katy Perry Featuring Kanye West
Give Me Everything - Pitbull Featuring Ne-Yo, Afrojack & Nayer
Grenade - Bruno Mars
Super Bass - Nicki Minaj
Moves Like Jagger - Maroon 5 Featuring Christina Aguilera
Just Can't Get Enough - The Black Eyed Peas
On The Floor - Jennifer Lopez Featuring Pitbull
S&M - Rihanna
Pumped Up Kicks - Foster The People
Last Friday Night (T.G.I.F.) - Katy Perry
Just The Way You Are - Bruno Mars
Tonight (I'm Lovin' You) - Enrique Iglesias Featuring Ludacris & DJ Frank E
Raise Your Glass - P!nk
Born This Way - Lady Gaga
F**kin' Perfect - P!nk
What's My Name? - Rihanna Featuring Drake
Look At Me Now - Chris Brown Featuring Lil Wayne & Busta Rhymes
Down On Me - Jeremih Featuring 50 Cent
How To Love - Lil Wayne
Someone Like You - Adele
Good Life - OneRepublic
The Lazy Song - Bruno Mars
Till The World Ends - Britney Spears
The Show Goes On - Lupe Fiasco
The Edge Of Glory - Lady Gaga
We R Who We R - Ke$ha
Black And Yellow - Wiz Khalifa
Tonight Tonight - Hot Chelle Rae
Blow - Ke$ha
Lighters - Bad Meets Evil Featuring Bruno Mars
If I Die Young - The Band Perry
Stereo Hearts - Gym Class Heroes Featuring Adam Levine
The Time (Dirty Bit) - The Black Eyed Peas
Coming Home - Diddy - Dirty Money Featuring Skylar Grey
Hey Baby (Drop It To The Floor) - Pitbull Featuring T-Pain
Only Girl (In The World) - Rihanna
6 Foot 7 Foot - Lil Wayne Featuring Cory Gunz
Just A Kiss - Lady Antebellum
Dirt Road Anthem - Jason Aldean
Dynamite - Taio Cruz
No Hands - Waka Flocka Flame Featuring Roscoe Dash & Wale
I Wanna Go - Britney Spears
I'm On One - DJ Khaled Featuring Drake, Rick Ross & Lil Wayne
You Make Me Feel... - Cobra Starship Featuring Sabi
Yeah 3X - Chris Brown
Moment 4 Life - Nicki Minaj Featuring Drake
I Need A Doctor - Dr. Dre Featuring Eminem & Skylar Grey
Just A Dream - Nelly
Motivation - Kelly Rowland Featuring Lil Wayne
Stereo Love - Edward Maya & Vika Jigulina
Jar Of Hearts - Christina Perri
Roll Up - Wiz Khalifa
Sexy And I Know It - LMFAO
Rocketeer - Far*East Movement Featuring Ryan Tedder
All Of The Lights - Kanye West
Hold It Against Me - Britney Spears
More - Usher
What The Hell - Avril Lavigne
Written In The Stars - Tinie Tempah Featuring Eric Turner
Bottoms Up - Trey Songz Featuring Nicki Minaj
DJ Got Us Fallin' In Love - Usher Featuring Pitbull
For The First Time - The Script
Honey Bee - Blake Shelton
Don't You Wanna Stay - Jason Aldean With Kelly Clarkson
We Found Love - Rihanna Featuring Calvin Harris
Pretty Girl Rock - Keri Hilson
You And I - Lady Gaga
Like A G6 - Far*East Movement Featuring Cataracs & Dev
Without You - David Guetta Featuring Usher
Back To December - Taylor Swift
Teenage Dream - Katy Perry
Crazy Girl - Eli Young Band
Cheers (Drink To That) - Rihanna
Who Says - Selena Gomez & The Scene
Barefoot Blue Jean Night - Jake Owen
Knee Deep - Zac Brown Band Featuring Jimmy Buffett
Country Girl (Shake It For Me) - Luke Bryan
Remind Me - Brad Paisley Duet With Carrie Underwood
In The Dark - Dev
Backseat - New Boyz Featuring The Cataracs & Dev
Headlines - Drake
Best Thing I Never Had - Beyonce
Don't Wanna Go Home - Jason Derulo
Where Them Girls At - David Guetta Featuring Flo Rida & Nicki Minaj
She Ain't You - Chris Brown
Take A Back Road - Rodney Atkins
Please Don't Go - Mike Posner
Sure Thing - Miguel
Price Tag - Jessie J Featuring B.o.B
God Gave Me You - Blake Shelton
She Will - Lil Wayne Featuring Drake
Are You Gonna Kiss Me Or Not - Thompson Square
Animal - Neon Trees
You And Tequila - Kenny Chesney Featuring Grace Potter
Colder Weather - Zac Brown Band
My Last - Big Sean Featuring Chris Brown
