Old Town Road - Lil Nas X Featuring Billy Ray Cyrus
Sunflower (Spider-Man: Into The Spider-Verse) - Post Malone & Swae Lee
Without Me - Halsey
Bad Guy - Billie Eilish
Wow. - Post Malone
Happier - Marshmello & Bastille
7 Rings - Ariana Grande
Talk - Khalid
Sicko Mode - Travis Scott
Sucker - Jonas Brothers
High Hopes - Panic! At The Disco
Thank U, Next - Ariana Grande
Truth Hurts - Lizzo
Dancing With A Stranger - Sam Smith & Normani
Senorita - Shawn Mendes & Camila Cabello
I Don't Care - Ed Sheeran & Justin Bieber
Eastside - benny blanco, Halsey & Khalid
Going Bad - Meek Mill Featuring Drake
Shallow - Lady Gaga & Bradley Cooper
Better - Khalid
No Guidance - Chris Brown Featuring Drake
Girls Like You - Maroon 5 Featuring Cardi B
Sweet But Psycho - Ava Max
Suge - DaBaby
Middle Child - J. Cole
Drip Too Hard - Lil Baby & Gunna
Someone You Loved - Lewis Capaldi
Ran$om - Lil Tecca
If I Can't Have You - Shawn Mendes
Goodbyes - Post Malone Featuring Young Thug
ZEZE - Kodak Black Featuring Travis Scott & Offset
Better Now - Post Malone
Youngblood - 5 Seconds Of Summer
Money In The Grave - Drake Featuring Rick Ross
Speechless - Dan + Shay
Break Up With Your Girlfriend, I'm Bored - Ariana Grande
Please Me - Cardi B & Bruno Mars
Money - Cardi B
You Need To Calm Down - Taylor Swift
Panini - Lil Nas X
Look Back At It - A Boogie Wit da Hoodie
A Lot - 21 Savage
ME! - Taylor Swift Featuring Brendon Urie
MIA - Bad Bunny Featuring Drake
Pop Out - Polo G Featuring Lil Tjay
Beautiful Crazy - Luke Combs
Thotiana - Blueface
Lucid Dreams - Juice WRLD
Mo Bamba - Sheck Wes
Beautiful People - Ed Sheeran Featuring Khalid
Wake Up In The Sky - Gucci Mane X Bruno Mars X Kodak Black
Whiskey Glasses - Morgan Wallen
God's Country - Blake Shelton
Be Alright - Dean Lewis
Pure Water - Mustard & Migos
The Git Up - Blanco Brown
Taki Taki - DJ Snake Featuring Selena Gomez, Ozuna & Cardi B
Close To Me - Ellie Goulding X Diplo Featuring Swae Lee
Envy Me - Calboy
You Say - Lauren Daigle
Hey Look Ma, I Made It - Panic! At The Disco
Circles - Post Malone
Beer Never Broke My Heart - Luke Combs
The London - Young Thug, J. Cole & Travis Scott
Con Calma - Daddy Yankee & Katy Perry Featuring Snow
Murder On My Mind - YNW Melly
When The Party's Over - Billie Eilish
Act Up - City Girls
I Like It - Cardi B, Bad Bunny & J Balvin
Trampoline - SHAED
Leave Me Alone - Flipp Dinero
Breathin - Ariana Grande
Bury A Friend - Billie Eilish
Close Friends - Lil Baby
Baby Shark - Pinkfong
My Type - Saweetie
Worth It - YK Osiris
Only Human - Jonas Brothers
Knockin' Boots - Luke Bryan
Trip - Ella Mai
Rumor - Lee Brice
Swervin - A Boogie Wit da Hoodie Featuring 6ix9ine
How Do You Sleep? - Sam Smith
Baby - Lil Baby & DaBaby
Look What God Gave Her - Thomas Rhett
Good As You - Kane Brown
Clout - Offset Featuring Cardi B
Love Lies - Khalid & Normani
One Thing Right - Marshmello & Kane Brown
Cash Shit - Megan Thee Stallion Featuring DaBaby
Tequila - Dan + Shay
Shotta Flow - NLE Choppa
Hot Girl Summer - Megan Thee Stallion, Nicki Minaj & Ty Dolla $ign
Talk You Out Of It - Florida Georgia Line
Beautiful - Bazzi Featuring Camila Cabello
Eyes On You - Chase Rice
All To Myself - Dan + Shay
Boyfriend - Ariana Grande & Social House
Walk Me Home - P!nk
Robbery - Juice WRLD
