Blinding Lights - The Weeknd
Circles - Post Malone
The Box - Roddy Ricch
Don't Start Now - Dua Lipa
Rockstar - DaBaby Featuring Roddy Ricch
Adore You - Harry Styles
Life Is Good - Future Featuring Drake
Memories - Maroon 5
The Bones - Maren Morris
Someone You Loved - Lewis Capaldi
Say So - Doja Cat
I Hope - Gabby Barrett Featuring Charlie Puth
Whats Poppin - Jack Harlow Featuring DaBaby, Tory Lanez & Lil Wayne
Dance Monkey - Tones And I
Savage - Megan Thee Stallion
Roxanne - Arizona Zervas
Intentions - Justin Bieber Featuring Quavo
Everything I Wanted - Billie Eilish
Roses - SAINt JHN
Watermelon Sugar - Harry Styles
Before You Go - Lewis Capaldi
Falling - Trevor Daniel
10,000 Hours - Dan + Shay & Justin Bieber
WAP - Cardi B Featuring Megan Thee Stallion
Ballin' - Mustard & Roddy Ricch
Hot Girl Bummer - blackbear
Blueberry Faygo - Lil Mosey
Heartless - The Weeknd
BOP - DaBaby
Lose You To Love Me - Selena Gomez
Good As Hell - Lizzo
Toosie Slide - Drake
Break My Heart - Dua Lipa
Chasin' You - Morgan Wallen
Savage Love (Laxed - Siren Beat) - Jawsh 685 x Jason Derulo
No Guidance - Chris Brown Featuring Drake
My Oh My - Camila Cabello Featuring DaBaby
Dynamite - BTS
Go Crazy - Chris Brown & Young Thug
High Fashion - Roddy Ricch Featuring Mustard
Laugh Now Cry Later - Drake Featuring Lil Durk
Woah - Lil Baby
Death Bed - Powfu Featuring beabadoobee
Senorita - Shawn Mendes & Camila Cabello
HIGHEST IN THE ROOM - Travis Scott
Bad Guy - Billie Eilish
Mood - 24kGoldn Featuring iann dior
Rain On Me - Lady Gaga & Ariana Grande
For The Night - Pop Smoke Featuring Lil Baby & DaBaby
RITMO (Bad Boys For Life) - Black Eyed Peas X J Balvin
Heart On Ice - Rod Wave
Nobody But You - Blake Shelton Duet With Gwen Stefani
Trampoline - SHAED
Come & Go - Juice WRLD x Marshmello
Truth Hurts - Lizzo
If The World Was Ending - JP Saxe Featuring Julia Michaels
We Paid - Lil Baby & 42 Dugg
Yummy - Justin Bieber
One Man Band - Old Dominion
Got What I Got - Jason Aldean
Sunday Best - Surfaces
Godzilla - Eminem Featuring Juice WRLD
Bandit - Juice WRLD & YoungBoy Never Broke Again
Party Girl - StaySolidRocky
Die From A Broken Heart - Maddie & Tae
Popstar - DJ Khaled Featuring Drake
All I Want For Christmas Is You - Mariah Carey
One Of Them Girls - Lee Brice
Hard To Forget - Sam Hunt
One Margarita - Luke Bryan
Panini - Lil Nas X
Hot - Young Thug Featuring Gunna
I Hope You're Happy Now - Carly Pearce & Lee Brice
Emotionally Scarred - Lil Baby
Suicidal - YNW Melly & Juice WRLD
The Bigger Picture - Lil Baby
Only Human - Jonas Brothers
The Woo - Pop Smoke Featuring 50 Cent & Roddy Ricch
Sum 2 Prove - Lil Baby
Stuck With U - Ariana Grande & Justin Bieber
Mood Swings - Pop Smoke Featuring Lil Tjay
You Should Be Sad - Halsey
Dior - Pop Smoke
Supalonely - BENEE Featuring Gus Dapperton
Even Though I'm Leaving - Luke Combs
The Scotts - THE SCOTTS, Travis Scott & Kid Cudi
Juicy - Doja Cat & Tyga
Be Like That - Kane Brown With Swae Lee & Khalid
Homesick - Kane Brown
Rags2Riches - Rod Wave Featuring ATR Son Son
Bluebird - Miranda Lambert
Wishing Well - Juice WRLD
Does To Me - Luke Combs Featuring Eric Church
P*$$y Fairy (OTW) - Jhene Aiko
ily - Surf Mesa Featuring Emilee
More Than My Hometown - Morgan Wallen
Lovin' On You - Luke Combs
Said Sum - Moneybagg Yo
Slide - H.E.R. Featuring YG
Walk Em Down - NLE Choppa Featuring Roddy Ricch
