Levitating - Dua Lipa
Save Your Tears - The Weeknd & Ariana Grande
Blinding Lights - The Weeknd
Mood - 24kGoldn Featuring iann dior
Good 4 U - Olivia Rodrigo
Kiss Me More - Doja Cat Featuring SZA
Leave The Door Open - Silk Sonic (Bruno Mars & Anderson .Paak)
Drivers License - Olivia Rodrigo
Montero (Call Me By Your Name) - Lil Nas X
Peaches - Justin Bieber Featuring Daniel Caesar & Giveon
Butter - BTS
Stay - The Kid LAROI & Justin Bieber
Deja Vu - Olivia Rodrigo
Positions - Ariana Grande
Bad Habits - Ed Sheeran
Heat Waves - Glass Animals
Without You - The Kid LAROI
Forever After All - Luke Combs
Go Crazy - Chris Brown & Young Thug
Astronaut In The Ocean - Masked Wolf
34+35 - Ariana Grande Feat. Doja Cat & Megan Thee Stallion
What You Know Bout Love - Pop Smoke
My Ex's Best Friend - Machine Gun Kelly X blackbear
Industry Baby - Lil Nas X & Jack Harlow
Therefore I Am - Billie Eilish
Up - Cardi B
Fancy Like - Walker Hayes
Dakiti - Bad Bunny & Jhay Cortez
Best Friend - Saweetie Featuring Doja Cat
Rapstar - Polo G
Heartbreak Anniversary - Giveon
For The Night - Pop Smoke Featuring Lil Baby & DaBaby
Calling My Phone - Lil Tjay Featuring 6LACK
Beautiful Mistakes - Maroon 5 Featuring Megan Thee Stallion
Holy - Justin Bieber Featuring Chance The Rapper
On Me - Lil Baby
You Broke Me First. - Tate McRae
Traitor - Olivia Rodrigo
Back In Blood - Pooh Shiesty Featuring Lil Durk
I Hope - Gabby Barrett Featuring Charlie Puth
Dynamite - BTS
Wockesha - Moneybagg Yo
You Right - Doja Cat & The Weeknd
Beat Box - SpotemGottem Featuring Pooh Shiesty Or DaBaby
Laugh Now Cry Later - Drake Featuring Lil Durk
Need To Know - Doja Cat
Wants And Needs - Drake Featuring Lil Baby
Way 2 Sexy - Drake Featuring Future & Young Thug
Telepatia - Kali Uchis
Whoopty - CJ
Lemonade - Internet Money & Gunna Featuring Don Toliver & NAV
Good Days - SZA
Starting Over - Chris Stapleton
Body - Megan Thee Stallion
Willow - Taylor Swift
Bang! - AJR
Better Together - Luke Combs
You're Mines Still - Yung Bleu Featuring Drake
Every Chance I Get - DJ Khaled Featuring Lil Baby & Lil Durk
Essence - Wizkid Featuring Justin Bieber & Tems
Chasing After You - Ryan Hurd With Maren Morris
The Good Ones - Gabby Barrett
Leave Before You Love Me - Marshmello X Jonas Brothers
Glad You Exist - Dan + Shay
Lonely - Justin Bieber & benny blanco
Beggin' - Maneskin
Streets - Doja Cat
What's Next - Drake
Famous Friends - Chris Young + Kane Brown
Lil Bit - Nelly & Florida Georgia Line
Thot Shit - Megan Thee Stallion
Late At Night - Roddy Ricch
Kings & Queens - Ava Max
Anyone - Justin Bieber
Track Star - Mooski
Time Today - Moneybagg Yo
Cry Baby - Megan Thee Stallion Featuring DaBaby
All I Want For Christmas Is You - Mariah Carey
No More Parties - Coi Leray Featuring Lil Durk
What's Your Country Song - Thomas Rhett
One Too Many - Keith Urban Duet With P!nk
Arcade - Duncan Laurence
Yonaguni - Bad Bunny
Good Time - Niko Moon
If I Didn't Love You - Jason Aldean & Carrie Underwood
Knife Talk - Drake Featuring 21 Savage & Project Pat
pov - Ariana Grande
Just The Way - Parmalee x Blanco Brown
Take My Breath - The Weeknd
We're Good - Dua Lipa
Hell Of A View - Eric Church
Rockin' Around The Christmas Tree - Brenda Lee
Put Your Records On - Ritt Momney
Happier Than Ever - Billie Eilish
Single Saturday Night - Cole Swindell
Things A Man Oughta Know - Lainey Wilson
Throat Baby (Go Baby) - BRS Kash
Tombstone - Rod Wave
Drinkin' Beer. Talkin' God. Amen. - Chase Rice Featuring Florida Georgia Line
Todo de Ti - Rauw Alejandro
