Physical - Olivia Newton-John
Bette Davis Eyes - Kim Carnes
Endless Love - Diana Ross & Lionel Richie
Eye Of The Tiger - Survivor
Every Breath You Take - The Police
Flashdance...What A Feeling - Irene Cara
Another One Bites The Dust - Queen
Say Say Say - Paul McCartney And Michael Jackson
Call Me - Blondie
Lady - Kenny Rogers
Centerfold - The J. Geils Band
(Just Like) Starting Over - John Lennon
I Love Rock 'N' Roll - Joan Jett & The Blackhearts
Ebony And Ivory - Paul McCartney And Stevie Wonder
That's What Friends Are For - Dionne & Friends Featuring Elton John, Gladys Knight And Stevie Wonder
Upside Down - Diana Ross
Billie Jean - Michael Jackson
Abracadabra - The Steve Miller Band
Say You, Say Me - Lionel Richie
All Night Long (All Night) - Lionel Richie
Waiting For A Girl Like You - Foreigner
Hurts So Good - John Cougar
Another Day In Paradise - Phil Collins
Do That To Me One More Time - Captain & Tennille
Like A Virgin - Madonna
When Doves Cry - Prince
Maneater - Daryl Hall John Oates
Another Brick In The Wall (Part II) - Pink Floyd
Faith - George Michael
Crazy Little Thing Called Love - Queen
Total Eclipse Of The Heart - Bonnie Tyler
Careless Whisper - Wham! Featuring George Michael
Walk Like An Egyptian - The Bangles
Don't You Want Me - The Human League
Jessie's Girl - Rick Springfield
Woman In Love - Barbra Streisand
Hard To Say I'm Sorry - Chicago
Miss You Much - Janet Jackson
Down Under - Men At Work
We Are The World - USA For Africa
Jack & Diane - John Cougar
Jump - Van Halen
Islands In The Stream - Kenny Rogers Duet With Dolly Parton
Coming Up (Live At Glasgow) - Paul McCartney And Wings
Arthur's Theme (Best That You Can Do) - Christopher Cross
Broken Wings - Mr. Mister
Alone - Heart
Can't Fight This Feeling - REO Speedwagon
Every Rose Has Its Thorn - Poison
I Wanna Dance With Somebody (Who Loves Me) - Whitney Houston
I Can't Go For That (No Can Do) - Daryl Hall John Oates
Livin' On A Prayer - Bon Jovi
Money For Nothing - Dire Straits
On My Own - Patti LaBelle & Michael McDonald
Beat It - Michael Jackson
Crazy For You - Madonna
What's Love Got To Do With It - Tina Turner
Rock With You - Michael Jackson
Separate Lives - Phil Collins and Marilyn Martin
I Want To Know What Love Is - Foreigner
It's Still Rock And Roll To Me - Billy Joel
Look Away - Chicago
Footloose - Kenny Loggins
Against All Odds (Take A Look At Me Now) - Phil Collins
Roll With It - Steve Winwood
Straight Up - Paula Abdul
Everybody Wants To Rule The World - Tears For Fears
We Didn't Start The Fire - Billy Joel
Nothing's Gonna Stop Us Now - Starship
With Or Without You - U2
The Power Of Love - Huey Lewis & The News
Greatest Love Of All - Whitney Houston
I Just Called To Say I Love You - Stevie Wonder
La Bamba - Los Lobos
Funkytown - Lipps, Inc.
Magic - Olivia Newton-John
One More Try - George Michael
Ghostbusters - Ray Parker Jr.
Gloria - Laura Branigan
Hello - Lionel Richie
Shout - Tears For Fears
Right Here Waiting - Richard Marx
Woman - John Lennon
Owner Of A Lonely Heart - Yes
Please Don't Go - KC And The Sunshine Band
Lost In Your Eyes - Debbie Gibson
Need You Tonight - INXS
Harden My Heart - Quarterflash
Shake You Down - Gregory Abbott
We Built This City - Starship
Stuck With You - Huey Lewis & The News
Party All The Time - Eddie Murphy
Never Gonna Give You Up - Rick Astley
Sweet Child O' Mine - Guns N' Roses
Everytime You Go Away - Paul Young
Don't Know Much - Linda Ronstadt (Featuring Aaron Neville)
Got My Mind Set On You - George Harrison
9 To 5 - Dolly Parton
Rock Me Amadeus - Falco
Like A Prayer - Madonna
